111111111
100C00001
111000E01
1000P011
1111111
